#########################
#.@.....................#
#.....+..........+......#
#..##########...........#
#.........#.....#########
#.........#.............#
####...####......+......#
#.........#.............#
#.........####...#......#
#...#######......#......#
#................######.#
#.......................#
#.+...#.................#
#.....#....+............#
####################....#
#..#.............+.#....#
#..#...............#....#
#.......#.....######....#
#.......#...............#
#....+..#...............#
#.......#################
#.......................#
#####...................#
#........#..............#
####################....#